28 28 28 28 28 28 28 28 28 28 28 28 28 28 28 28 28 28 28 28 28 28 28 28 28 28 28 28 28 28 28 28 28 28 28 28 28 28 28 28 28 28 28 28 28 28 28 28 28 28
28 28 28 28 28 28 28 28 28 28 28 28 28 28 28 28 28 28 28 28 28 28 28 28 28 28 28 28 28 28 28 28 28 28 28 28 28 28 28 28 28 28 28 28 28 28 28 28 28 28
28 28 28 28 28 28 28 28 28 28 28 28 28 28 28 28 28 28 28 28 28 28 28 28 28 28 28 28 28 28 28 28 28 28 28 28 28 28 28 28 28 28 28 28 28 28 28 28 28 28
28 28 28 28 28 28 28 28 28 28 28 28 28 28 28 28 28 28 28 28 28 28 28 28 28 28 28 28 28 28 28 28 28 28 28 28 28 28 28 28 28 28 28 28 28 28 28 28 28 28
28 28 28 28 28 28 28 28 28 28 28 28 28 28 28 28 28 28 28 28 28 28 28 28 28 28 28 28 28 28 28 28 28 28 28 28 28 28 28 28 28 28 28 28 28 28 28 28 28 28
28 28 28 28 28 28 28 28 28 28 28 28 28 28 28 28 28 28 28 28 28 28 28 28 28 28 28 28 28 28 28 28 28 28 28 28 28 28 28 28 28 28 28 28 28 28 28 28 28 28
28 28 28 28 28 28 28 28 28 28 28 28 28 28 28 28 28 28 28 28 28 28 28 28 28 28 28 28 28 28 28 28 28 28 28 28 28 28 28 28 28 28 28 28 28 28 28 28 28 28
28 28 28 28 28 28 28 38 36 36 36 36 36 36 36 36 36 36 36 36 36 36 36 36 36 36 36 36 36 36 36 36 36 36 28 36 36 28 36 36 36 36 39 28 28 28 28 28 28 28
28 28 28 28 28 28 28 34 26 26 11 26 26 26 11 26 11 20 26 26 11 26 20 23 11 11 11 11 11 11 11 11 11 11 11 11 11 11 11 11 11 11 33 28 28 28 28 28 28 28
28 28 28 28 28 28 28 34 26 11 26 27 26 26 27 11 26 27 27 27 27 26 27 17 11 11 11 11 11 11 11 11 11 11 11 11 11 11 11 11 11 11 33 28 28 28 28 28 28 28
28 28 28 28 28 28 28 34 26 27 26 26 26 26 27 26 27 27 27 26 26 27 26 20 23 11 11 11 11 11 11 11 11 11 11 11 11 11 11 11 11 11 33 28 28 28 28 28 28 28
28 28 28 28 28 28 28 34 11 26 27 26 27 27 27 27 26 27 26 26 26 26 27 27 17 11 11 11 11 11 11 11 12 12 12 12 12 12 11 11 11 11 33 28 28 28 28 28 28 28
28 28 28 28 28 28 28 34 26 11 26 27 27 27 27 27 27 27 27 27 27 27 27 27 17 11 11 11 11 11 11 11 12 30 31 31 31 32 12 11 11 11 33 28 28 28 28 28 28 28
28 28 28 28 28 28 28 34 26 26 26 26 26 27 27 26 27 26 27 27 27 27 27 27 17 11 11 11 11 11 11 11 12 18 27 27 27 17 12 11 11 11 33 28 28 28 28 28 28 28
28 28 28 28 28 28 28 34 11 26 26 26 27 27 26 11 26 26 26 26 11 26 15 15 25 11 11 11 11 11 11 11 12 35 36 39 38 37 12 11 11 11 33 28 28 28 28 28 28 28
28 28 28 28 28 28 28 34 26 26 11 26 27 27 26 26 26 27 26 27 26 11 11 11 11 11 11 11 11 11 11 11 12 12 12 33 34 12 12 11 11 11 33 28 28 28 28 28 28 28
28 28 28 28 28 28 28 34 26 27 26 26 27 27 26 26 11 26 11 26 11 11 11 11 11 11 11 11 11 11 11 11 20 20 20 33 34 20 20 20 11 11 33 28 28 28 28 28 28 28
28 28 28 28 28 28 28 34 26 26 27 27 26 27 27 27 26 26 11 26 11 11 11 11 11 11 11 11 11 11 11 20 20 20 20 33 34 20 20 20 11 11 33 28 28 28 28 28 28 28
28 28 28 28 28 28 28 34 26 27 26 26 27 27 27 26 27 26 26 11 11 11 11 11 11 11 11 11 11 20 20 20 20 20 20 33 34 20 20 20 11 11 33 28 28 28 28 28 28 28
28 28 28 28 28 28 28 34 11 15 11 18 27 27 27 17 15 11 11 11 11 11 11 11 11 11 11 11 11 20 20 20 20 20 20 33 34 20 20 20 20 11 33 28 28 28 28 28 28 28
28 28 28 28 28 28 28 34 11 11 11 18 27 27 27 17 11 11 11 11 11 11 11 11 11 11 11 11 20 20 20 20 20 20 20 33 34 20 20 20 20 11 33 28 28 28 28 28 28 28
28 28 28 28 28 28 28 34 11 11 11 24 15 15 15 25 11 11 11 11 11 11 11 11 11 11 11 11 11 11 11 11 11 11 11 33 34 11 11 11 11 11 33 28 28 28 28 28 28 28
28 28 28 28 28 28 28 34 11 11 11 11 11 11 11 11 11 11 11 11 11 11 20 20 20 11 11 11 11 11 11 11 11 11 11 33 34 11 11 11 11 11 33 28 28 28 28 28 28 28
28 28 28 28 28 28 28 34 11 11 11 11 11 11 11 11 11 11 11 11 11 11 20 11 20 11 11 11 11 11 11 11 11 11 11 33 34 11 11 11 11 11 33 28 28 28 28 28 28 28
28 28 28 28 28 28 28 34 11 11 11 11 11 11 11 11 11 11 11 11 11 11 20 20 20 11 11 11 11 11 11 11 11 11 11 33 34 11 11 11 11 11 33 28 28 28 28 28 28 28
28 28 28 28 28 28 28 40 31 31 31 31 31 31 44 44 31 31 31 31 31 31 31 31 31 31 31 31 31 31 31 31 31 31 31 41 40 40 31 31 31 31 41 28 28 28 28 28 28 28
28 28 28 28 28 28 28 28 29 28 28 28 28 28 44 44 28 28 28 28 28 28 28 28 28 28 28 28 28 29 28 28 28 28 28 28 28 28 28 28 28 28 28 28 28 28 28 28 28 28
28 28 28 28 28 28 28 28 28 28 28 28 29 28 44 44 28 28 28 28 28 29 28 28 28 28 28 28 28 28 28 28 28 28 28 28 28 28 28 29 28 28 28 28 28 28 28 28 28 28
28 28 28 28 28 28 28 29 28 28 29 28 28 28 44 44 28 28 28 28 28 28 28 28 29 28 28 28 28 28 28 28 28 29 28 28 28 28 28 28 28 28 28 28 28 28 28 28 28 28
28 28 28 28 28 28 28 38 36 36 36 36 36 36 44 44 36 36 36 36 36 36 36 36 36 36 36 36 36 36 36 36 36 36 36 36 36 29 36 36 36 36 39 28 28 28 28 28 28 28
28 28 28 28 28 28 28 34 11 11 11 11 11 11 11 11 11 11 11 11 11 11 11 11 11 11 11 11 11 11 11 11 11 11 11 11 11 11 11 11 11 11 33 28 28 28 28 28 28 28
28 28 28 28 28 28 28 34 11 11 11 11 11 11 11 11 11 11 11 11 11 11 11 11 11 11 26 11 11 11 11 11 11 11 11 11 11 11 11 11 11 11 33 28 28 28 28 28 28 28
28 28 28 28 28 28 28 34 11 11 11 11 11 11 11 11 11 11 11 11 11 11 11 11 11 11 11 11 42 42 42 42 42 42 42 42 42 42 42 42 42 11 33 28 28 28 28 28 28 28
28 28 28 28 28 28 28 34 11 11 11 11 11 11 11 11 11 11 11 11 11 11 11 11 11 26 11 11 42 44 44 44 44 44 44 44 44 44 44 44 42 11 33 28 28 28 28 28 28 28
28 28 28 28 28 28 28 34 11 11 11 11 11 11 30 31 31 31 31 31 31 32 11 11 11 11 11 11 42 44 44 44 44 44 44 44 44 44 44 44 42 11 33 28 28 28 28 28 28 28
28 28 28 28 28 28 28 34 11 11 11 11 11 11 33 28 28 28 29 28 29 34 11 11 11 11 11 11 42 44 44 44 44 44 44 44 44 44 44 44 42 11 33 28 28 28 28 28 28 28
28 28 28 28 28 28 28 34 11 11 11 11 11 11 33 28 29 28 28 28 28 34 11 11 11 11 11 11 11 44 44 44 44 44 44 44 44 44 44 44 42 11 33 28 28 28 28 28 28 28
28 28 28 28 28 28 28 34 11 11 11 11 11 11 33 28 28 29 28 29 28 34 11 11 11 11 11 11 42 44 44 44 44 44 44 44 44 44 44 44 42 11 33 28 28 28 28 28 28 28
28 28 28 28 28 28 28 34 11 11 11 11 11 11 35 36 36 36 36 36 36 37 11 11 11 11 11 11 42 44 44 44 44 44 44 44 44 44 44 44 42 11 33 28 28 28 28 28 28 28
28 28 28 28 28 28 28 34 11 11 11 11 11 11 11 11 11 11 11 11 11 11 11 11 11 11 11 11 42 44 44 44 44 44 44 44 44 44 44 44 42 11 33 28 28 28 28 28 28 28
28 28 28 28 28 28 28 34 11 11 11 11 11 11 11 11 11 11 11 11 11 11 11 11 11 11 11 11 42 42 42 42 42 42 42 42 42 42 42 42 42 11 33 28 28 28 28 28 28 28
28 28 28 28 28 28 28 34 11 11 11 11 11 11 11 11 11 11 11 11 11 11 11 11 11 11 11 11 11 11 11 11 11 11 11 11 11 11 11 11 11 11 33 28 28 28 28 28 28 28
28 28 28 28 28 28 28 40 31 31 31 31 31 31 31 31 31 31 31 31 31 31 31 31 31 31 31 31 31 31 31 31 31 31 31 31 31 31 31 31 31 31 41 28 28 28 28 28 28 28
28 28 28 28 28 28 28 28 28 28 28 28 28 28 28 28 28 28 28 28 28 28 28 28 28 28 28 28 28 28 28 28 28 28 28 28 28 28 28 28 28 28 28 28 28 28 28 28 28 28
28 28 28 28 28 28 28 28 28 28 28 28 28 28 28 28 28 28 28 28 28 28 28 28 28 28 28 28 28 28 28 28 28 28 28 28 28 28 28 28 28 28 28 28 28 28 28 28 28 28
28 28 28 28 28 28 28 28 28 28 28 28 28 28 28 28 28 28 28 28 28 28 28 28 28 28 28 28 28 28 28 28 28 28 28 28 28 28 28 28 28 28 28 28 28 28 28 28 28 28
28 28 28 28 28 28 28 28 28 28 28 28 28 28 28 28 28 28 28 28 28 28 28 28 28 28 28 28 28 28 28 28 28 28 28 28 28 28 28 28 28 28 28 28 28 28 28 28 28 28
28 28 28 28 28 28 28 28 28 28 28 28 28 28 28 28 28 28 28 28 28 28 28 28 28 28 28 28 28 28 28 28 28 28 28 28 28 28 28 28 28 28 28 28 28 28 28 28 28 28
28 28 28 28 28 28 28 28 28 28 28 28 28 28 28 28 28 28 28 28 28 28 28 28 28 28 28 28 28 28 28 28 28 28 28 28 28 28 28 28 28 28 28 28 28 28 28 28 28 28
28 28 28 28 28 28 28 28 28 28 28 28 28 28 28 28 28 28 28 28 28 28 28 28 28 28 28 28 28 28 28 28 28 28 28 28 28 28 28 28 28 28 28 28 28 28 28 28 28 28
